compressed	item
Compressed Amber Cytoserocin	Amber Cytoserocin
Compressed Amber Mykoserocin	Amber Mykoserocin
Compressed Azure Cytoserocin	Azure Cytoserocin
Compressed Azure Mykoserocin	Azure Mykoserocin
Compressed Celadon Cytoserocin	Celadon Cytoserocin
Compressed Celadon Mykoserocin	Celadon Mykoserocin
Compressed Fullerite-C28	Fullerite-C28
Compressed Fullerite-C32	Fullerite-C32
Compressed Fullerite-C320	Fullerite-C320
Compressed Fullerite-C50	Fullerite-C50
Compressed Fullerite-C540	Fullerite-C540
Compressed Fullerite-C60	Fullerite-C60
Compressed Fullerite-C70	Fullerite-C70
Compressed Fullerite-C72	Fullerite-C72
Compressed Fullerite-C84	Fullerite-C84
Compressed Golden Cytoserocin	Golden Cytoserocin
Compressed Golden Mykoserocin	Golden Mykoserocin
Compressed Lime Cytoserocin	Lime Cytoserocin
Compressed Lime Mykoserocin	Lime Mykoserocin
Compressed Malachite Cytoserocin	Malachite Cytoserocin
Compressed Malachite Mykoserocin	Malachite Mykoserocin
Compressed Vermillion Cytoserocin	Vermillion Cytoserocin
Compressed Vermillion Mykoserocin	Vermillion Mykoserocin
Compressed Viridian Cytoserocin	Viridian Cytoserocin
Compressed Viridian Mykoserocin	Viridian Mykoserocin
